301;P301;Male;4;2;3;A;1
302;P302;Male;4;3;3;A;1
303;P303;Female;2;1;3;A;1
304;P304;Male;4;0;3;A;0
305;P305;Female;1;0;3;A;1
401;P401;Male;4;0;4;B;1
402;P402;Female;4;4;4;B;1
403;P403;Male;2;2;4;B;1